11 11
1 1 1 1 1 1 1 1 1 1 1
1 0 0 0 0 0 0 0 0 0 1
1 0 0 0 0 0 0 0 0 0 1
1 0 0 0 0 0 0 0 0 0 1
1 0 0 0 0 0 0 0 0 0 1
1 0 0 0 0 0 0 0 0 0 1
1 0 0 0 0 0 1 1 1 1 1
1 0 0 0 0 0 1 0 0 0 1
1 0 0 0 0 0 5 0 9 0 1
1 0 0 0 0 0 1 0 0 0 1
1 1 1 1 1 1 1 1 1 1 1
3 3
1
7 3
1
3 9 1 0
1
9 5 1 0