12 12
1 1 1 1 1 1 1 1 1 1 1 1
1 0 0 0 0 1 0 0 0 0 0 1
1 0 0 0 0 1 0 0 0 0 0 1
1 0 0 0 0 1 0 0 0 0 0 1
1 0 0 0 0 5 0 0 0 0 0 1
1 0 0 0 0 1 0 0 0 0 0 1
1 1 5 1 1 1 1 1 1 1 1 1
1 0 0 0 0 1 0 0 0 1 1 1
1 0 0 0 0 5 0 9 0 1 1 1
1 0 0 0 0 1 0 0 0 1 1 1
1 0 0 0 0 1 1 1 1 1 1 1
1 1 1 1 1 1 1 1 1 1 1 1
3 8
2
4 7
2 2
2
1 10 1 0
1 1 0 0
4
3 6 3 0
3 4 1 0
5 1 2 0
7 4 1 0