17 15
1 1 1 1 1 1 1 1 1 1 1 1 1 1 1
1 0 0 0 0 0 0 1 1 1 1 1 1 1 1
1 0 0 0 0 0 0 1 0 0 0 0 0 0 1
1 0 0 0 0 0 0 5 0 0 0 0 0 0 1
1 0 0 0 0 0 0 1 0 0 0 0 0 0 1
1 0 0 0 0 0 0 1 0 0 0 0 0 0 1
1 1 5 1 1 1 1 1 0 0 0 0 0 0 1
1 0 0 0 0 0 1 1 1 1 5 1 1 1 1
1 0 0 0 0 0 1 0 0 0 0 0 0 1 1
1 0 0 0 0 0 5 0 0 0 0 0 0 1 1
1 0 0 0 0 0 1 0 0 0 0 0 0 1 1
1 0 0 0 0 0 1 0 0 0 0 0 0 1 1
1 1 1 5 1 1 1 0 0 0 0 0 0 1 1
1 1 0 0 0 1 1 0 0 0 0 0 0 1 1
1 1 0 9 0 1 1 1 1 1 1 1 1 1 1
1 1 0 0 0 1 1 1 1 1 1 1 1 1 1
1 1 1 1 1 1 1 1 1 1 1 1 1 1 1
9 3
4
8 4
3 2
5 9
10 11
2
10 1 3 0
2 8 3 1
5
7 1 0 0
2 6 1 0
6 9 2 0
10 7 3 1
11 4 2 1