22 13
1 1 1 1 1 1 1 1 1 1 1 1 1
1 1 1 1 1 0 0 0 1 1 1 1 1
1 1 1 1 1 0 9 0 1 1 1 1 1
1 1 1 1 1 0 0 0 1 1 1 1 1
1 1 1 1 1 1 5 1 1 1 1 1 1
1 1 1 1 1 0 0 0 1 1 1 1 1
1 1 1 1 1 0 0 0 1 1 1 1 1
1 1 1 1 1 0 0 0 1 1 1 1 1
1 1 1 1 1 1 5 1 1 1 1 1 1
1 0 0 0 0 0 0 0 0 0 0 0 1
1 0 0 0 0 0 0 0 0 0 0 0 1
1 0 0 0 0 0 0 0 0 0 0 0 1
1 0 0 0 0 0 0 0 0 0 0 0 1
1 0 0 0 0 0 0 0 0 0 0 0 1
1 0 0 0 0 1 1 1 0 0 0 0 1
1 0 0 0 0 1 1 1 0 0 0 0 1
1 0 0 0 0 1 1 1 0 0 0 0 1
1 0 0 0 0 0 0 0 0 0 0 0 1
1 0 0 0 0 0 0 0 0 0 0 0 1
1 0 0 0 0 0 0 0 0 0 0 0 1
1 0 0 0 0 0 0 0 0 0 0 0 1
1 1 1 1 1 1 1 1 1 1 1 1 1
15 2
2
11 3
11 9
2
15 11 1 0
13 6 2 1
2
9 5 0 0
5 5 0 1