19 16
1 1 1 1 1 1 1 1 1 1 1 1 1 1 1 1
1 0 0 0 0 0 0 0 0 0 0 1 0 0 0 1
1 0 0 0 0 0 0 0 0 0 0 5 0 9 0 1
1 0 0 0 0 0 0 0 0 0 0 1 0 0 0 1
1 0 0 0 0 0 0 0 0 0 0 1 1 2 1 1
1 0 0 0 0 0 0 0 0 0 0 1 0 0 0 1
1 0 0 0 0 0 0 0 0 0 0 2 0 0 0 1
1 0 0 0 0 0 0 0 0 0 0 1 0 0 0 1
1 1 2 1 0 0 0 1 2 1 2 1 0 0 0 1
1 0 0 0 0 0 0 0 0 0 0 2 0 0 0 1
1 0 0 0 0 0 0 0 0 0 0 1 0 0 0 1
1 0 0 0 0 0 0 0 0 0 0 5 0 0 0 1
1 0 0 0 0 0 0 0 0 0 0 1 0 0 0 1
1 0 0 0 0 0 0 0 0 0 0 2 0 0 0 1
1 1 1 1 1 1 2 1 2 1 2 1 0 0 0 1
1 0 0 0 1 0 0 0 0 0 0 0 0 0 0 1
1 0 0 0 5 0 0 0 0 0 0 0 0 0 0 1
1 0 0 0 1 0 0 0 0 0 0 0 0 0 0 1
1 1 1 1 1 1 1 1 1 1 1 1 1 1 1 1
2 8
3
11 1
6 13
16 2
2
1 2 0 0
16 1 3 1
3
12 10 1 0
15 5 1 0
3 10 1 1