16 13
1 1 1 1 1 1 1 1 1 1 1 1 1
1 0 0 0 0 0 0 0 0 0 0 0 1
1 0 0 0 0 0 0 0 0 0 0 0 1
1 0 0 0 0 0 0 0 0 0 0 0 1
1 1 1 1 5 1 1 1 0 0 0 0 1
1 0 0 0 0 0 0 2 0 0 0 0 1
1 0 0 0 0 0 0 2 0 0 0 0 1
1 0 0 0 0 0 0 2 0 0 0 0 1
1 0 0 0 0 0 0 2 0 0 0 0 1
1 0 0 0 0 0 0 2 0 0 0 0 1
1 0 0 0 0 0 0 2 0 0 0 0 1
1 1 1 1 1 1 1 1 0 0 0 0 1
1 1 1 1 0 0 0 1 0 0 0 0 1
1 1 1 1 0 9 0 5 0 0 0 0 1
1 1 1 1 0 0 0 1 0 0 0 0 1
1 1 1 1 1 1 1 1 1 1 1 1 1
9 2
2
6 2
2 6
2
7 11 1 0
2 1 3 1
2
5 3 0 0
12 8 3 1