14 13
1 1 1 1 1 1 1 1 1 1 1 1 1
1 1 0 0 0 1 1 1 0 0 0 0 1
1 1 0 9 0 1 1 1 0 0 0 0 1
1 1 0 0 0 1 1 1 0 0 0 0 1
1 1 1 5 1 1 1 1 0 0 0 0 1
1 0 0 0 0 0 0 1 0 0 0 0 1
1 0 0 0 0 0 0 1 0 0 0 0 1
1 0 0 0 0 0 0 5 0 0 0 0 1
1 0 0 0 0 0 0 1 0 0 0 0 1
1 1 1 5 1 1 1 1 0 0 0 0 1
1 0 0 0 0 0 0 1 0 0 0 0 1
1 0 0 0 0 0 0 1 0 0 0 0 1
1 0 0 0 0 0 0 1 0 0 0 0 1
1 1 1 1 1 1 1 1 1 1 1 1 1
4 10
2
9 10
6 2
2
12 10 2 0
12 6 2 1
3
6 8 3 0
8 4 2 0
5 4 0 1