13 19
1 1 1 1 1 1 1 1 1 1 1 1 1 1 1 1 1 1 1
1 0 0 0 0 0 0 0 1 0 0 0 1 1 1 1 1 1 1
1 0 0 0 0 0 0 0 1 0 0 0 1 0 0 0 0 0 1
1 0 0 0 0 0 0 0 5 0 0 0 5 0 0 0 0 0 1
1 0 0 0 1 0 0 0 1 0 0 0 1 0 0 0 0 0 1
1 0 0 0 1 0 0 0 1 0 0 0 1 0 0 0 0 0 1
1 0 0 0 1 5 1 1 1 1 1 1 1 1 5 1 1 1 1
1 0 0 0 0 0 0 0 0 1 1 1 1 0 0 0 1 1 1
1 0 0 0 0 0 0 0 0 1 1 1 1 0 9 0 1 1 1
1 0 0 0 0 0 0 0 0 1 1 1 1 0 0 0 1 1 1
1 0 0 0 0 0 0 0 0 1 1 1 1 1 1 1 1 1 1
1 0 0 0 0 0 0 0 0 1 1 1 1 1 1 1 1 1 1
1 1 1 1 1 1 1 1 1 1 1 1 1 1 1 1 1 1 1
8 2
3
8 2
2 2
1 9
2
8 8 1 0
5 11 2 1
4
2 7 1 0
2 11 1 1
5 6 2 1
5 13 2 1