17 15
1 1 1 1 1 1 1 1 1 1 1 1 1 1 1
1 1 1 1 1 0 0 0 1 1 1 1 1 1 1
1 0 0 0 1 0 9 0 1 1 1 1 1 1 1
1 0 0 0 1 0 0 0 1 1 1 1 1 1 1
1 0 0 0 1 1 5 1 1 1 1 1 1 1 1
1 1 5 1 1 0 0 0 0 1 1 1 1 1 1
1 0 0 0 2 0 0 0 0 1 0 0 0 0 1
1 0 0 0 2 0 0 0 0 5 0 0 0 0 1
1 0 0 0 2 0 0 0 0 1 0 0 0 0 1
1 0 0 0 1 0 0 0 0 1 0 0 0 0 1
1 0 0 0 1 0 0 0 0 1 0 0 0 0 1
1 0 0 0 1 1 1 1 1 1 0 0 0 0 1
1 0 0 0 0 0 0 0 0 0 0 0 0 0 1
1 0 0 0 0 0 0 0 0 0 0 0 0 0 1
1 0 0 0 0 0 0 0 0 0 0 0 0 0 1
1 0 0 0 0 0 0 0 0 0 0 0 0 0 1
1 1 1 1 1 1 1 1 1 1 1 1 1 1 1
13 5
2
13 3
3 2
2
15 1 2 0
10 8 1 1
3
6 1 0 0
6 8 1 0
5 5 0 1