12 13
1 1 1 1 1 1 1 1 1 1 1 1 1
1 0 0 0 1 0 0 0 1 0 0 0 1
1 0 0 0 1 0 9 0 5 0 0 0 1
1 0 0 0 1 0 0 0 1 0 0 0 1
1 0 0 0 1 1 1 1 1 0 0 0 1
1 0 0 0 1 0 0 0 1 0 0 0 1
1 0 0 0 1 0 0 0 1 0 0 0 1
1 0 0 0 1 0 0 0 1 0 0 0 1
1 0 0 0 0 0 0 0 0 0 0 0 1
1 0 0 0 0 0 0 0 0 0 0 0 1
1 0 0 0 0 0 0 0 0 0 0 0 1
1 1 1 1 1 1 1 1 1 1 1 1 1
10 6
2
6 5
6 7
1
1 2 0 0
1
3 9 3 0