20 14
1 1 1 1 1 1 1 1 1 1 1 1 1 1
1 0 0 0 1 0 0 0 1 0 0 0 0 1
1 0 0 0 1 0 9 0 1 0 0 0 0 1
1 0 0 0 1 0 0 0 1 0 0 0 0 1
1 0 0 0 1 1 5 1 1 1 1 5 1 1
1 0 0 0 1 0 0 0 2 0 0 0 0 1
1 0 0 0 1 0 0 0 2 0 0 0 0 1
1 0 0 0 1 0 0 0 2 0 0 0 0 1
1 0 0 0 1 1 5 1 1 0 0 0 0 1
1 0 0 0 0 0 0 0 1 0 0 0 0 1
1 0 0 0 0 0 0 0 1 0 0 0 0 1
1 0 0 0 0 0 0 0 0 0 0 0 0 1
1 0 0 0 0 0 0 0 0 0 0 0 0 1
1 0 0 0 0 0 0 0 0 0 0 0 0 1
1 0 0 0 0 0 0 0 0 0 0 0 0 1
1 2 2 2 0 0 0 0 0 0 2 2 2 1
1 0 0 0 0 0 0 0 0 0 0 0 0 1
1 0 0 0 0 0 0 0 0 0 0 0 0 1
1 0 0 0 0 0 0 0 0 0 0 0 0 1
1 1 1 1 1 1 1 1 1 1 1 1 1 1
13 6
3
10 6
1 9
3 9
2
1 1 0 0
1 11 0 1
3
5 7 0 0
5 12 0 0
9 7 0 1